13
1111111111111
1000010001001
1000010001001
1000010001001
1000010001001
1111111111111
1000010000001
1000010000001
1000011111111
1000010000001
1000010000001
1111111111111